DDDDDDDDDDDDDDDDDDDDDDDDDDDDDDDDDDDDDDDDD
DDDDDDDDDDDDDDDDDDDDDDDDDDDDDDDDDDDDDDDDD
DDDDDDDDDDDDDDDDDDDDDDDDDDDDDDDDDDDDDDDDD
DDD.........DDDD..G.G....DDDD.GKKKKK..DDD
DDD.G.GGGGG.DDDD..G.G.GG.DDDD.GKG.GKKKDDD
DDD.GKKKKKKKDDDD..KKKKKG.DDDD.GKG.GGGKDDD
DDD.GKDDD..KDDDD..KDDDK..DDDD..KDDD.GKDDD
DDDKKKDDDGGKDDDDGKKDDDKGGDDDDGGKDDD.GKDDD
DDDKGGDDDKKKDDDD.KDDDDKKDDDDD..KDDDKKKDDD
DDDK..DDDKG.DDDDDKDDDDDKDDDDD.GKDDDKGGDDD
DDDKGGDDDKG.DDDDDKKDDDDK.DDDD..KDDDK..DDD
DDDKK.DDDKGGDDDD.GKDDDKK.DDDD..KDDDKKKDDD
DDDDK.DDDKK.DDDDGGKDDDKG.DDDDGGKDDDGGKDDD
DDDDKDDDDDK.DDDD..KDDDKG.DDDD..KDDD..KDDD
DDD.KDDDDDKDDDDD..KDDDK..DDDD.GKDDD..KDDD
DDDKK.DDD.KDDDDD.GKDDDKG.DDDD.GKDDD.GKDDD
DDDKGGDDDKK.DDDD..KDDDKG.DDDD.KKDDDGGKDDD
DDDKK.DDDKGGDDDD..KDDDKGGDDDDDKDDDD.GKDDD
DDDGKGDDDKKKDDDDGGKDDDK..DDDD.K.DDD.KKDDD
DDDGKGDDD..KDDDD..KDDDKGGDDDDKK.DDDDKDDDD
DDDKK.DDDGGKDDDD.GKDDDKG.DDDDKGGDDD.K.DDD
DDDKG.DDDGGKDDDD..KDDDKG.DDDDKG.DDD.KKDDD
DDDKG.DDD..KDDDD..KDDDKG.DDDDKG.DDDGGKDDD
DDDKG.DDD..KDDDD..KDDDK..DDDDK..DDD.GKDDD
DDDK..DDDGGKDDDDGGKDDDKGGDDDDKG.DDD.GKDDD
DDDKGGDDD..KDDDD.KKDDDKK.DDDDK..DDDKKKDDD
DDDK..DDD.GKDDDDDKDDDDDKDDDDDKGGDDDKGGDDD
DDDKGGDDD.GKDDDD.KKDDD.KKDDDDK..DDDK..DDD
DDDK..DDD.GKDDDD.GKDDD..KDDDDKKKDDDKKKDDD
DDDKGGDDDDKKDDDDGGKDDD.GKDDDDGGKDDDGGKDDD
DDDK..DDDDKDDDDD..KDDD..KDDDD.GKDDD..KDDD
DDDK..DDD.K.DDDD.GKDDDGGKDDDD.GKDDD.GKDDD
DDDKGGDDDKK.DDDD..KDDD.GKDDDD.KKDDDGGKDDD
DDDKK.DDDKGGDDDD..KDDD.GKDDDDDKDDDD.GKDDD
DDDGKGDDDKKKDDDDGGKDDD.KKDDDD.KKDDD..KDDD
DDD.K.DDDGGKKKKKKKKDDD.KG.G.G..KDDDGKKDDD
DDD.I.DDD.G.G...GG.DDD.KG.G.GGGKDDD.K.DDD
DDD...DDD..........DDD.KKKKKKKKKDDD...DDD
DDDDDDDDDDDDDDDDDDDDDDDDDDDDDDDDDDDDDDDDD
DDDDDDDDDDDDDDDDDDDDDDDDDDDDDDDDDDDDDDDDD
DDDDDDDDDDDDDDDDDDDDDDDDDDDDDDDDDDDDDDDDD